You step outside of your small cottage that was heavy with the scent of bitter herbs and an unspoken, pervasive worry. Your mother, Miren, lies on her cot, her breathing shallow and ragged, each rasp a painful reminder of the strange illness gripping her. Outside, the land of Eldwyn itself seems to hold its breath, the vibrant greens muted, the air still and uneasy since the disappearance of Emberwing, its mighty dragon guardian.

A desperate resolve begins to form within you. Old village tales whisper of remedies linked to the land's deepest magic, to the very essence of the dragons. Perhaps answers, and a cure for Miren, lie hidden in the whispering wilds beyond Brelmere, or within forgotten lore known only to a few... Your gaze might instinctively drift towards the old forest path, or perhaps the village elder holds some fragment of wisdom that could light the way.

The Riddle of Emberwing - Prologue
An Interactive Fiction by LeikRad
Release 1 / Serial number 250602 / Inform 7 build 6M62 (I6/v6.33 lib 6/12N) SD

Village Center
The heart of Brelmere pulses with unease. Villagers murmur and exchange worried glances.

An old man in a soaked hood, carrying a satchel of maps and scrolls. He stands near the entrance of the village weared out, just as if he had ran for days straight.

>look around
You can't see any such thing.

* * *

>pick up guiding stone
Taken.

>inventory
You are carrying:
  a Guiding Stone

>go east
Crossroads
There is a warning sign here.

>go eats
You can't see any such thing.

>go east
Birchwood Path Entrance
A strange fog envelops everything, you barely can see your feet when you look down.

* * *

>pick up
(the Guiding Stone)
Taken.

>east
Crossroads
Blahblah.

>east
Trail Entrance
You see a warning sign.

>west
Entrance to Birchwood Path
A strange fog envelops everything, you barely can see your feet when you look down.

>esast
That's not a verb I recognise.

* * *

>east
Trail Entrance
You see a warning sign.

>east
MushroomCount is 0.

Birchwood Path
A strange fog envelops everything, you can barely see your feet when you look down.

You see light eminating from a hollow tree trunk.

>west
Birchwood Path
A strange fog envelops everything, you barely can see your feet when you look down.

>east
Birchwood Path
A strange fog envelops everything, you barely can see your feet when you look down.

>north
Birchwood Path
A strange fog envelops everything, you barely can see your feet when you look down.

>south
Birchwood Path
A strange fog envelops everything, you barely can see your feet when you look down.

>use guiding
The Guiding Stone vibrates gently and pulls you toward safety...

Trail Entrance
You see a warning sign.

The fresh air seems light compared to the dense fog, you feel relieved.

* * *

>east
MushroomCount is 0.

Birchwood Path
A strange fog envelops everything, you can barely see your feet when you look down.

You see light eminating from a hollow tree trunk.

>pick up
(the Tree Mushroom)
You carefully pick the Tree Mushroom. Your MushCount is now 1.

>east
MushroomCount is 1.

Birchwood Path
A strange fog envelops everything, you can barely see your feet when you look down.

You see a faint glowing near the ground in the fog.

>pick up
(the Glowing Mushroom)
You carefully pick the Glowing Mushroom. Your MushCount is now 2.

>east
MushroomCount is 2.

Birchwood Path
A strange fog envelops everything, you can barely see your feet when you look down.

A deer picks at the ground. It looks like it's trying to eat something.

>pick up
(the Covered Mushroom)
You carefully pick the Covered Mushroom. Your MushCount is now 3.

>east
MushroomCount is 3.
*** Couldn't read from entry 1 of a list which is empty ***

*** Run-time problem P50: Attempt to use list item which does not exist.

Birchwood Path
A strange fog envelops everything, you can barely see your feet when you look down.

* * *

>east
Crossroads
Blahblah.

>eastt
That's not a verb I recognise.

>east
Trail Entrance
You see a warning sign.

>east
MushCount before entering Birchwood: 0. Available: Glowing Mushroom, Tree Mushroom and Covered Mushroom.
The path is shrouded in mist, revealing nothing out of the ordinary.
Mushroom spawn chance failed.

Birchwood Path
A strange fog envelops everything, you can barely see your feet when you look down.

>east
MushCount before entering Birchwood: 0. Available: Glowing Mushroom, Tree Mushroom and Covered Mushroom.
The path is shrouded in mist, revealing nothing out of the ordinary.
Mushroom spawn chance failed.

Birchwood Path
A strange fog envelops everything, you can barely see your feet when you look down.

>east
MushCount before entering Birchwood: 0. Available: Glowing Mushroom, Tree Mushroom and Covered Mushroom.
You notice something peculiar on the ground as you step into the fog.
Spawned Glowing Mushroom in Birchwood Path.

Birchwood Path
A strange fog envelops everything, you can barely see your feet when you look down.

You see a faint glowing near the ground in the fog.

>east
MushCount before entering Birchwood: 0. Available: Glowing Mushroom, Tree Mushroom and Covered Mushroom.
Removed the Glowing Mushroom from Birchwood Path.
The path is shrouded in mist, revealing nothing out of the ordinary.
Mushroom spawn chance failed.

Birchwood Path
A strange fog envelops everything, you can barely see your feet when you look down.

I beg your pardon?

I beg your pardon?

* * *

>pick up
(the Guiding Stone)
Taken.

>testmush
That's not a verb I recognise.

* * *

>east
Crossroads
Blahblah.

>east
MushCount before entering Birchwood: 0. Available: Glowing Mushroom, Tree Mushroom and Covered Mushroom.
The path is shrouded in mist, revealing nothing out of the ordinary.
Mushroom spawn chance failed.
Mushroom spawn chance (2 in 10) failed.

Birchwood Path
A strange fog envelops everything, you can barely see your feet when you look down.

>east
MushCount before entering Birchwood: 0. Available: Glowing Mushroom, Tree Mushroom and Covered Mushroom.
The path is shrouded in mist, revealing nothing out of the ordinary.
Mushroom spawn chance failed.
Mushroom spawn chance (3 in 10) failed.

Birchwood Path
A strange fog envelops everything, you can barely see your feet when you look down.

>west
Crossroads
Blahblah.

>east
Trail Entrance
You see a warning sign.

* * *

>east
MushCount before entering Birchwood: 0. Available: Glowing Mushroom, Tree Mushroom and Covered Mushroom.
The path is shrouded in mist, revealing nothing out of the ordinary.
Mushroom spawn chance failed.
Mushroom spawn chance (3 in 10) failed.

Birchwood Path
A strange fog envelops everything, you can barely see your feet when you look down.

>east
MushCount before entering Birchwood: 0. Available: Glowing Mushroom, Tree Mushroom and Covered Mushroom.
You notice something peculiar on the ground as you step into the fog.
Spawned Covered Mushroom in Birchwood Path.

Birchwood Path
A strange fog envelops everything, you can barely see your feet when you look down.

A deer picks at the ground. It looks like it's trying to eat something.

>north
Birchwood Path
A strange fog envelops everything, you barely can see your feet when you look down.

* * *

>east
MushCount before entering Birchwood: 0. Available: Glowing Mushroom, Tree Mushroom and Covered Mushroom.
You notice something peculiar on the ground as you step into the fog.
Spawned Covered Mushroom in Birchwood Path.

Birchwood Path
A strange fog envelops everything, you can barely see your feet when you look down.

A deer picks at the ground. It looks like it's trying to eat something.

>east
MushCount before entering Birchwood: 0. Available: Glowing Mushroom, Tree Mushroom and Covered Mushroom.
You notice something peculiar on the ground as you step into the fog.
Spawned Covered Mushroom in Birchwood Path.

Birchwood Path
A strange fog envelops everything, you can barely see your feet when you look down.

A deer picks at the ground. It looks like it's trying to eat something.

>esat
That's not a verb I recognise.

>east
Birchwood Path
A strange fog envelops everything, you can barely see your feet when you look down.

You can see a Covered Mushroom here.

>east
Birchwood Path
A strange fog envelops everything, you can barely see your feet when you look down.

You can see a Tree Mushroom here.

* * *

>east
MushCount before entering Birchwood: 0. Available: Glowing Mushroom, Tree Mushroom and Covered Mushroom.
You notice something peculiar on the ground as you step into the fog.
Spawned Covered Mushroom in Birchwood Path.

Birchwood Path
A strange fog envelops everything, you can barely see your feet when you look down.

A deer picks at the ground. It looks like it's trying to eat something.

>east
MushCount before entering Birchwood: 0. Available: Covered Mushroom, Tree Mushroom and Glowing Mushroom.
Removed the Covered Mushroom from Birchwood Path.
The path is shrouded in mist, revealing nothing out of the ordinary.
Mushroom spawn chance failed.
Mushroom spawn chance (2 in 10) failed.

Birchwood Path
A strange fog envelops everything, you can barely see your feet when you look down.

>east
MushCount before entering Birchwood: 0. Available: Covered Mushroom, Tree Mushroom and Glowing Mushroom.
The path is shrouded in mist, revealing nothing out of the ordinary.
Mushroom spawn chance failed.
Mushroom spawn chance (3 in 10) failed.

Birchwood Path
A strange fog envelops everything, you can barely see your feet when you look down.

>north
Cave Entrance
You encroach on a strange terrain formation with three slots near some stones that seem to heavy to move on your own.

>east
You can't go that way.

>south
MushCount before entering Birchwood: 0. Available: Covered Mushroom, Tree Mushroom and Glowing Mushroom.
The path is shrouded in mist, revealing nothing out of the ordinary.
Mushroom spawn chance failed.
Mushroom spawn chance (4 in 10) failed.

Birchwood Path
A strange fog envelops everything, you can barely see your feet when you look down.

* * *

>east
MushCount before entering Birchwood: 0. Available: Glowing Mushroom, Tree Mushroom and Covered Mushroom.
You notice something peculiar on the ground as you step into the fog.
Spawned Covered Mushroom in Birchwood Path.

Birchwood Path
A strange fog envelops everything, you can barely see your feet when you look down.

A deer picks at the ground. It looks like it's trying to eat something.

>pick up
(the Covered Mushroom)
You carefully pick the Covered Mushroom. Your MushCount is now 1.

>east
MushCount before entering Birchwood: 1. Available: Glowing Mushroom and Tree Mushroom.
The path is shrouded in mist, revealing nothing out of the ordinary.
Mushroom spawn chance failed.
Mushroom spawn chance (2 in 10) failed.

Birchwood Path
A strange fog envelops everything, you can barely see your feet when you look down.

>pick up
(the Covered Mushroom)
You already have that.

>east
MushCount before entering Birchwood: 1. Available: Glowing Mushroom and Tree Mushroom.
The path is shrouded in mist, revealing nothing out of the ordinary.
Mushroom spawn chance failed.
Mushroom spawn chance (3 in 10) failed.

Birchwood Path
A strange fog envelops everything, you can barely see your feet when you look down.

>east
MushCount before entering Birchwood: 1. Available: Glowing Mushroom and Tree Mushroom.
The path is shrouded in mist, revealing nothing out of the ordinary.
Mushroom spawn chance failed.
Mushroom spawn chance (4 in 10) failed.

Birchwood Path
A strange fog envelops everything, you can barely see your feet when you look down.

>east
MushCount before entering Birchwood: 1. Available: Glowing Mushroom and Tree Mushroom.
The path is shrouded in mist, revealing nothing out of the ordinary.
Mushroom spawn chance failed.
Mushroom spawn chance (5 in 10) failed.

Birchwood Path
A strange fog envelops everything, you can barely see your feet when you look down.

>eat
(the Covered Mushroom)
That's plainly inedible.

>east
MushCount before entering Birchwood: 1. Available: Glowing Mushroom and Tree Mushroom.
The path is shrouded in mist, revealing nothing out of the ordinary.
Mushroom spawn chance failed.
Mushroom spawn chance (6 in 10) failed.

Birchwood Path
A strange fog envelops everything, you can barely see your feet when you look down.

>east
MushCount before entering Birchwood: 1. Available: Glowing Mushroom and Tree Mushroom.
You notice something peculiar on the ground as you step into the fog.
Spawned Glowing Mushroom in Birchwood Path.

Birchwood Path
A strange fog envelops everything, you can barely see your feet when you look down.

You see a faint glowing near the ground in the fog.

>pickup
That's not a verb I recognise.

>east
MushCount before entering Birchwood: 1. Available: Glowing Mushroom and Tree Mushroom.
Removed the Glowing Mushroom from Birchwood Path.
The path is shrouded in mist, revealing nothing out of the ordinary.
Mushroom spawn chance failed.
Mushroom spawn chance (2 in 10) failed.

Birchwood Path
A strange fog envelops everything, you can barely see your feet when you look down.

>east
MushCount before entering Birchwood: 1. Available: Glowing Mushroom and Tree Mushroom.
The path is shrouded in mist, revealing nothing out of the ordinary.
Mushroom spawn chance failed.
Mushroom spawn chance (3 in 10) failed.

Birchwood Path
A strange fog envelops everything, you can barely see your feet when you look down.

* * *

>east
MushCount before entering Birchwood: 1. Available: Glowing Mushroom and Tree Mushroom.
The path is shrouded in mist, revealing nothing out of the ordinary.
Mushroom spawn chance failed.
Mushroom spawn chance (5 in 10) failed.

Birchwood Path
A strange fog envelops everything, you can barely see your feet when you look down.

>east
MushCount before entering Birchwood: 1. Available: Glowing Mushroom and Tree Mushroom.
The path is shrouded in mist, revealing nothing out of the ordinary.
Mushroom spawn chance failed.
Mushroom spawn chance (6 in 10) failed.

Birchwood Path
A strange fog envelops everything, you can barely see your feet when you look down.

* * *

>east
MushCount before entering Birchwood: 1. Available: Glowing Mushroom and Tree Mushroom.
You notice something peculiar on the ground as you step into the fog.
Spawned Glowing Mushroom in Birchwood Path.

Birchwood Path
A strange fog envelops everything, you can barely see your feet when you look down.

You see a faint glowing near the ground in the fog.

>pick up
(the Glowing Mushroom)
You carefully pick the Glowing Mushroom. Your MushCount is now 2.

>east
MushCount before entering Birchwood: 2. Available: Tree Mushroom.
The path is shrouded in mist, revealing nothing out of the ordinary.
Mushroom spawn chance failed.
Mushroom spawn chance (2 in 10) failed.

Birchwood Path
A strange fog envelops everything, you can barely see your feet when you look down.

>east
MushCount before entering Birchwood: 2. Available: Tree Mushroom.
The path is shrouded in mist, revealing nothing out of the ordinary.
Mushroom spawn chance failed.
Mushroom spawn chance (3 in 10) failed.

Birchwood Path
A strange fog envelops everything, you can barely see your feet when you look down.

>east
MushCount before entering Birchwood: 2. Available: Tree Mushroom.
The path is shrouded in mist, revealing nothing out of the ordinary.
Mushroom spawn chance failed.
Mushroom spawn chance (4 in 10) failed.

Birchwood Path
A strange fog envelops everything, you can barely see your feet when you look down.

>east
MushCount before entering Birchwood: 2. Available: Tree Mushroom.
The path is shrouded in mist, revealing nothing out of the ordinary.
Mushroom spawn chance failed.
Mushroom spawn chance (5 in 10) failed.

Birchwood Path
A strange fog envelops everything, you can barely see your feet when you look down.

>east
MushCount before entering Birchwood: 2. Available: Tree Mushroom.
The path is shrouded in mist, revealing nothing out of the ordinary.
Mushroom spawn chance failed.
Mushroom spawn chance (6 in 10) failed.

Birchwood Path
A strange fog envelops everything, you can barely see your feet when you look down.

>east
MushCount before entering Birchwood: 2. Available: Tree Mushroom.
You notice something peculiar on the ground as you step into the fog.
Spawned Tree Mushroom in Birchwood Path.

Birchwood Path
A strange fog envelops everything, you can barely see your feet when you look down.

You see light eminating from a hollow tree trunk.

>pick up
(the Tree Mushroom)
You carefully pick the Tree Mushroom. Your MushCount is now 3.

>go north
Cave Entrance
You encroach on a strange terrain formation with stones that seem to heavy to move on your own.

Three oddly shaped slots are carved deep into the stone. They are all currently empty, expectantly waiting.

>put Tree into slot
The Tree Mushroom slides into a slot with a snug fit. You hear a faint, woody resonance.
With the Tree Mushroom placed, one slot is now filled. Two more to go.

>put Glowing into lsot
You can't see any such thing.

I beg your pardon?

>put Glowing into slot
You carefully place the Glowing Mushroom into one of the slots. It settles in with a soft click and emits a steady, faint light.
That's two mushrooms in place now. Just one more mystical fungus needed!

>put mushroom into slot
The Covered Mushroom fits neatly into a slot. A subtle earthy scent wafts from it.
As the Covered Mushroom settles into the final slot, all three mushrooms begin to glow in powerful unison, their combined light pushing back the shadows. A deep, resonant hum vibrates through the very stone beneath your feet. With a slow, grinding groan that echoes around the clearing, the rock wall shudders and then slides ponderously aside, revealing a dark passage leading north into the mountain's heart!

>go north
Crystal Caverns
BALGLAGLASDLGDSLG.

You can see a Dragon Eye here.

>pick up
(the Dragon Eye)
As your fingers close around the Dragon Eye, a surge of warmth flows up your arm. The gem pulses brightly, and you feel a profound connection to the ancient magic woven into the very stones of these caverns.
A subtle tremor runs through the ground, and the air shimmers momentarily. You sense a shift in the pathways of this mystical place A new passage seems to have opened from these Crystal Caverns, leading directly south towards the surface! Simultaneously, you feel that the Trail Entrance itself now holds a direct, albeit hidden, route leading north, straight to these deeper caves.

Taken.

>go south
Cave Entrance
You encroach on a strange terrain formation with stones that seem to heavy to move on your own.

Three oddly shaped slots are carved deep into the stone. All three slots are now filled with mushrooms. They seem to pulse with a gentle, collective energy, as if waiting for a final catalyst or perhaps having already fulfilled their purpose.

>go west
You can't go that way.

>go east
You can't go that way.

>go south
MushCount before entering Birchwood: 3. Available: .
The path is shrouded in mist, revealing nothing out of the ordinary.
Mushroom spawn chance failed.
Mushroom spawn chance (2 in 10) failed.

Birchwood Path
A strange fog envelops everything, you can barely see your feet when you look down.

>go east
MushCount before entering Birchwood: 3. Available: .
The path is shrouded in mist, revealing nothing out of the ordinary.
Mushroom spawn chance failed.
Mushroom spawn chance (3 in 10) failed.

Birchwood Path
A strange fog envelops everything, you can barely see your feet when you look down.

>go west
Crossroads
Blahblah.

>go south
Whispering Marsh
The thick fog covers the swamp like a veil. The vegetation whispers in the wind, and ahead, the entrance to a forgotten village can be glimpsed.

>go south
Burnt Village Grounds
The heart of Ashen Hollow, now in ruins. The ground is covered in ashes, and the silence is as heavy as stone.

>go northeast
Burnt Seer's House
The seer's former dwelling. Fragments of colored glass still glint in the broken windows, as if awaiting new visions.

You can see a Seer's Note here.

>pick up
(the Seer's Note)
As you read the note, you feel a shiver. It's as if something ancient is trying to remember…

>go southwest
Burnt Village Grounds
The heart of Ashen Hollow, now in ruins. The ground is covered in ashes, and the silence is as heavy as stone.

>got south
That's not a verb I recognise.

>go south
Burnt Blacksmith
Twisted tools and molten metals are scattered across the floor. The ancient heat still seems to emanate from the blackened walls.

You can see a Blacksmith's Note here.

>pick up
(the Blacksmith's Note)
The words echo in your mind, like fragments of a forgotten prophecy.

>go north
Burnt Village Grounds
The heart of Ashen Hollow, now in ruins. The ground is covered in ashes, and the silence is as heavy as stone.

>go southwest
Burnt Tavern
Broken tables, overturned benches, and charred barrels tell tales of lost nights. A sweet smell of smoke still hangs in the air.

You can see a Tavern Note here.

>pick up
(the Tavern Note)
The words "In the hearth of sorrow, scales endure" shine for a brief moment. It seems to be the key to something.

The three notes form a clear message. Something awaits you in the central hearth of the village...

>go northeast
Burnt Village Grounds
The heart of Ashen Hollow, now in ruins. The ground is covered in ashes, and the silence is as heavy as stone.

You can see a Dragon Scale here.

>pick up
(the Dragon Scale)
As soon as you touch the scale, you hear a distant whisper: "I remember you...".

>go north
Whispering Marsh
The thick fog covers the swamp like a veil. The vegetation whispers in the wind, and ahead, the entrance to a forgotten village can be glimpsed.

>go northg
You can't see any such thing.

>go north
Crossroads
Blahblah.

>go west
Village Center
The heart of Brelmere pulses with unease. Villagers murmur and exchange worried glances.

An old man in a soaked hood, carrying a satchel of maps and scrolls.

>go west
Village Path
A leaf-covered path leads back to the village of Brelmere, silent and shrouded in mist.

>go west
Forest
A dense and silent forest, covered in damp mist. Shadows dance among the ancient trunks.

>go west
Glen
The fog drifts between the trees of the glade. The distant sound of running water mingles with the chirping of unseen birds. In the center of the clearing, half-buried in moss and earth, rises a stone obelisk.

A stone structure covered in moss. Glowing runes are engraved on its surface.

>go west
Valley

>go west
Cliff

>go west
Skyreach Monastery Exterior
You've reached the monastery atop the sheer cliffs of Skyreach. It is eerily silent and clearly abandoned. Ancient scrolls, tattered by wind and time, lay scattered across a weathered courtyard. The monastery's great bell has toppled from its tower, half-buried and cracked.

>go north
Skyreach Interior Hall
This vast, circular hall must have been the heart of the Skyreach Monastery. Dust motes dance in the few rays of light that pierce the gloom from high, narrow windows. The air is still and heavy with forgotten prayers. In the very center of the stone floor, a large, intricate circular pattern is deeply carved.

You can see a FloorSockets here.

>put eye in socket
You carefully place the Dragon Eye into the round, orb-shaped socket. It fits perfectly, and for a moment, the flame within the Eye seems to flare, casting dancing shadows.
The Eye rests in its socket, pulsing faintly. The other socket remains empty.

>put scale in socket
You lay the Dragon Scale into the teardrop-shaped depression. It settles with a soft click, its weight seeming to press down on a hidden mechanism.

As both the Eye and Scale settle into their respective sockets, the carved lines of the floor pattern begin to glow with an intense, ethereal light! The air crackles with energy. Suddenly, a deafening CRACK shatters the silence as a brilliant bolt of pure lightning descends from the shadowy ceiling above, striking the very center of the pattern with pinpoint accuracy!
Where the lightning struck, the stone floor has been blasted open, or perhaps magically parted. Amidst smoking edges, the Stone of Storms now lies revealed. It is a shard of obsidian, humming with a potent, contained energy and reflecting an unseen light within its polished facets.
You glance upwards. Through a newly formed, jagged hole in the monastery's ancient roof, the previously tumultuous storm clouds are rapidly parting, revealing a serene, starlit sky. The howling wind that buffeted the monastery dies down to a gentle, almost reverent breeze.
In the newfound stillness, a mighty, triumphant roar echoes from some far-distant mountain peak, carried on the clear night air.

>pick up
What do you want to pick up?

>pick up orb
You can't see any such thing.

>pick up orb of storms
You can't see any such thing.

>look around
You can't see any such thing.

>inventory
You are carrying:
  a Tavern Note
  a Blacksmith's Note
  a Seer's Note

>pikc up stone
That's not a verb I recognise.

>pick up stone
As you take the Orb of Storms, you feel tremors as if the very winds and earth try to shake the very foundation of the monastery.

>go south
As you take your first steps away from the monastery, the Stone of Storms pulsing faintly in your grasp, the very air around you grows inexplicably cold. A vast, winged shadow sweeps over the desolate passes, plunging you into sudden twilight. The faint scent of ozone and something impossibly ancient fills your senses.
With a sound like a mountainside shearing in two, a colossal form lands directly before you, its impact shaking the precarious path. It's Emberwing, scales deep with scars, iridescent gold of the brighest day, its eyes like molten gold, burning with an intelligent, ancient light. The air around it crackles visibly with contained power. It fixes its gaze upon the Stone of Storms, then slowly, deliberately, upon you.
The dragon lowers its massive, horned head, close enough now that you can feel the warmth radiating from its nostrils. A voice, deep and resonant as rolling thunder, echoes not in your ears, but directly within the confines of your mind"I was deceived," the dragon mumbles, a hint of something unreadable in its tone - sadness? Or perhaps ancient sorrow. "A hunter stole my essence, scattered it. You brought me back."
You feel that the orb that you took is starting to dissintagrate. The dragon speaks again - "Thanks to you, I'm able to regain my power, and bring prosperity and peace to nature. As a show of gratitude, I would see you home, mortal...? - The dragon waits patiently for your name""Tarin, my name's Tarin." You blurt out. "Ah what a fine name. Then let's not take much longer, I'm sure your peers and family are waiting for you and your newfound counts of adventure.
You hop on to Emberwings back, and after a few seconds you are only able to see clouds beneath you, Emberwing's magicks helping you balance on it's back. Landing just outside the village, the commotion has drawn a crowd, and you can see your fellow villagers, including your mother.
But just as you are about to part ways, you hear the Dragon's voice inside your head again: "Your stories are more important than you think. As the great cycles turn, their wisdom will be sought anew. Hold onto their truth, Tarin, for the storms may gather again."
You are home. The adventure with the Stone of Storms is over, but the dragon's words linger, a promise and a warning entwined.

THE END... ?

    *** The End ***

Would you like to RESTART, RESTORE a saved game, QUIT or UNDO the last command?

* * *

>east
MushCount before entering Birchwood: 0. Available: Glowing Mushroom, Tree Mushroom and Covered Mushroom.
The path is shrouded in mist, revealing nothing out of the ordinary.
Mushroom spawn chance failed.
Mushroom spawn chance (3 in 10) failed.

Birchwood Path
A strange fog envelops everything, you can barely see your feet when you look down.

>north
Cave Entrance
You encroach on a strange terrain formation with stones that seem to heavy to move on your own.

Three oddly shaped slots are carved deep into the stone. One slot now holds a mushroom, which emits a faint, almost imperceptible hum. Two empty slots remain.

>east
You can't go that way.

>south
MushCount before entering Birchwood: 0. Available: Glowing Mushroom, Tree Mushroom and Covered Mushroom.
You notice something peculiar on the ground as you step into the fog.
Spawned Glowing Mushroom in Birchwood Path.

Birchwood Path
A strange fog envelops everything, you can barely see your feet when you look down.

You see a faint glowing near the ground in the fog.

* * *

>north
Cave Entrance
You encroach on a strange terrain formation with stones that seem to heavy to move on your own.

Three oddly shaped slots are carved deep into the stone. One slot now holds a mushroom, which emits a faint, almost imperceptible hum. Two empty slots remain.

>look at mushslots
Three oddly shaped slots are carved deep into the stone. They are all currently empty, expectantly waiting.

* * *

>north
Cave Entrance
You encroach on a strange terrain formation with stones that seem to heavy to move on your own.

Three oddly shaped slots are carved deep into the stone. One slot now holds a mushroom, which emits a faint, almost imperceptible hum. Two empty slots remain.

>go north
Crystal Caverns
BALGLAGLASDLGDSLG.

You can see a Dragon Eye here.

>pick up
(the Dragon Eye)
Taken.

* * *

>east
MushCount before entering Birchwood: 0. Available: Glowing Mushroom, Tree Mushroom and Covered Mushroom.
The path is shrouded in mist, revealing nothing out of the ordinary.
Mushroom spawn chance failed.
Mushroom spawn chance (2 in 10) failed.

Birchwood Path
A strange fog envelops everything, you can barely see your feet when you look down.

>esat
That's not a verb I recognise.

>east
You can't go that way.

>esat
That's not a verb I recognise.

>esat
That's not a verb I recognise.

* * *

>east
You can't go that way.

>west
Birchwood Path

>west
You can't go that way.

* * *

>east
MushCount before entering Birchwood: 0. Available: Glowing Mushroom, Tree Mushroom and Covered Mushroom.
The path is shrouded in mist, revealing nothing out of the ordinary.
Mushroom spawn chance failed.
Mushroom spawn chance (2 in 10) failed.

Birchwood Path
A strange fog envelops everything, you can barely see your feet when you look down.

>ast
That's not a verb I recognise.

>east
MushCount before entering Birchwood: 0. Available: Glowing Mushroom, Tree Mushroom and Covered Mushroom.
The path is shrouded in mist, revealing nothing out of the ordinary.
Mushroom spawn chance failed.
Mushroom spawn chance (2 in 10) failed.

Birchwood Path
A strange fog envelops everything, you can barely see your feet when you look down.

>north
Cave Entrance
You encroach on a strange terrain formation with stones that seem to heavy to move on your own.

You can see a MushSlots here.

>east
You can't go that way.

>north
You can't go that way.

>south
Birchwood Path
A strange fog envelops everything, you barely can see your feet when you look down.

>North
Birchwood Path West of Birchwood Path is Birchwood Path

>south
Birchwood Path
A strange fog envelops everything, you barely can see your feet when you look down.

>east
Birchwood Path
A strange fog envelops everything, you barely can see your feet when you look down.

* * *

>east
MushCount before entering Birchwood: 0. Available: Glowing Mushroom, Tree Mushroom and Covered Mushroom.
The path is shrouded in mist, revealing nothing out of the ordinary.
Mushroom spawn chance failed.
Mushroom spawn chance (2 in 10) failed.

Birchwood Path
A strange fog envelops everything, you can barely see your feet when you look down.

>west
MushCount before entering Birchwood: 0. Available: Glowing Mushroom, Tree Mushroom and Covered Mushroom.
The path is shrouded in mist, revealing nothing out of the ordinary.
Mushroom spawn chance failed.
Mushroom spawn chance (3 in 10) failed.

Birchwood Path
A strange fog envelops everything, you can barely see your feet when you look down.

>exit
But you aren't in anything at the moment.

* * *

>east
Crossroads
Blahblah.

>ast
That's not a verb I recognise.

>east
Trail Entrance
You see a warning sign.

>east
MushCount before entering Birchwood: 0. Available: Glowing Mushroom, Tree Mushroom and Covered Mushroom.
The path is shrouded in mist, revealing nothing out of the ordinary.
Mushroom spawn chance failed.
Mushroom spawn chance (2 in 10) failed.

Birchwood Path
A strange fog envelops everything, you can barely see your feet when you look down.

>pick up mushroom
Taken.

>go north
MushroomCount is 0.

Birchwood Path
A strange fog envelops everything, you can barely see your feet when you look down.

You can see a Glowing Mushroom here.

>inventoryt
You are carrying nothing.

>inventory
You are carrying nothing.

>pikcup mushroom
That's not a verb I recognise.

>pickup mushroom
That's not a verb I recognise.

>picku p mushroom
That's not a verb I recognise.

>pick up mushroom
Taken.

>inventory
You are carrying:
  a Glowing Mushroom

>go east
MushroomCount is 0.

Birchwood Path
A strange fog envelops everything, you can barely see your feet when you look down.

A deer picks at the ground. It looks like it's trying to eat something.

>invetory
That's not a verb I recognise.

>inventory
You are carrying:
  a Glowing Mushroom

>pick up mushroom
(the Covered Mushroom)
Taken.

>invetory
That's not a verb I recognise.

>inventory
You are carrying:
  a Covered Mushroom
  a Glowing Mushroom

>go east
MushroomCount is 0.

Birchwood Path
A strange fog envelops everything, you can barely see your feet when you look down.

You can see a Covered Mushroom here.

>inventory
You are carrying:
  a Glowing Mushroom

* * *

>east
MushCount before entering Birchwood: 0. Available: Glowing Mushroom, Tree Mushroom and Covered Mushroom.
The path is shrouded in mist, revealing nothing out of the ordinary.
Mushroom spawn chance failed.
Mushroom spawn chance (2 in 10) failed.

Birchwood Path
A strange fog envelops everything, you can barely see your feet when you look down.

>east
MushCount before entering Birchwood: 0. Available: Glowing Mushroom, Tree Mushroom and Covered Mushroom.
You notice something peculiar on the ground as you step into the fog.
Spawned Covered Mushroom in Birchwood Path.

Birchwood Path
A strange fog envelops everything, you can barely see your feet when you look down.

A deer picks at the ground. It looks like it's trying to eat something.

>east
MushCount before entering Birchwood: 0. Available: Covered Mushroom, Glowing Mushroom and Tree Mushroom.
Removed the Covered Mushroom from Birchwood Path.
The path is shrouded in mist, revealing nothing out of the ordinary.
Mushroom spawn chance failed.
Mushroom spawn chance (2 in 10) failed.

Birchwood Path
A strange fog envelops everything, you can barely see your feet when you look down.

>east
MushCount before entering Birchwood: 0. Available: Covered Mushroom, Glowing Mushroom and Tree Mushroom.
The path is shrouded in mist, revealing nothing out of the ordinary.
Mushroom spawn chance failed.
Mushroom spawn chance (3 in 10) failed.

Birchwood Path
A strange fog envelops everything, you can barely see your feet when you look down.

>east
MushCount before entering Birchwood: 0. Available: Covered Mushroom, Glowing Mushroom and Tree Mushroom.
The path is shrouded in mist, revealing nothing out of the ordinary.
Mushroom spawn chance failed.
Mushroom spawn chance (4 in 10) failed.

Birchwood Path
A strange fog envelops everything, you can barely see your feet when you look down.

>east
MushCount before entering Birchwood: 0. Available: Covered Mushroom, Glowing Mushroom and Tree Mushroom.
You notice something peculiar on the ground as you step into the fog.
Spawned Tree Mushroom in Birchwood Path.

Birchwood Path
A strange fog envelops everything, you can barely see your feet when you look down.

You see light eminating from a hollow tree trunk.

>east
MushCount before entering Birchwood: 0. Available: Covered Mushroom, Glowing Mushroom and Tree Mushroom.
Removed the Covered Mushroom from Birchwood Path.
You notice something peculiar on the ground as you step into the fog.
Spawned Glowing Mushroom in Birchwood Path.

Birchwood Path
A strange fog envelops everything, you can barely see your feet when you look down.

You see a faint glowing near the ground in the fog.

>east
MushCount before entering Birchwood: 0. Available: Glowing Mushroom, Tree Mushroom and Covered Mushroom.
Removed the Glowing Mushroom from Birchwood Path.
The path is shrouded in mist, revealing nothing out of the ordinary.
Mushroom spawn chance failed.
Mushroom spawn chance (6 in 10) failed.

Birchwood Path
A strange fog envelops everything, you can barely see your feet when you look down.

>east
MushCount before entering Birchwood: 0. Available: Glowing Mushroom, Tree Mushroom and Covered Mushroom.
You notice something peculiar on the ground as you step into the fog.
Spawned Tree Mushroom in Birchwood Path.

Birchwood Path
A strange fog envelops everything, you can barely see your feet when you look down.

You see light eminating from a hollow tree trunk.

>east
MushCount before entering Birchwood: 0. Available: Tree Mushroom, Covered Mushroom and Glowing Mushroom.
Removed the Tree Mushroom from Birchwood Path.
You notice something peculiar on the ground as you step into the fog.
Spawned Glowing Mushroom in Birchwood Path.

Birchwood Path
A strange fog envelops everything, you can barely see your feet when you look down.

You see a faint glowing near the ground in the fog.

>eats
That's not a verb I recognise.

>east
MushCount before entering Birchwood: 0. Available: Glowing Mushroom, Covered Mushroom and Tree Mushroom.
Removed the Glowing Mushroom from Birchwood Path.
You notice something peculiar on the ground as you step into the fog.
Spawned Covered Mushroom in Birchwood Path.

Birchwood Path
A strange fog envelops everything, you can barely see your feet when you look down.

A deer picks at the ground. It looks like it's trying to eat something.

>east
MushCount before entering Birchwood: 0. Available: Covered Mushroom, Glowing Mushroom and Tree Mushroom.
Removed the Covered Mushroom from Birchwood Path.
You notice something peculiar on the ground as you step into the fog.
Spawned Glowing Mushroom in Birchwood Path.

Birchwood Path
A strange fog envelops everything, you can barely see your feet when you look down.

You see a faint glowing near the ground in the fog.

>east
MushCount before entering Birchwood: 0. Available: Glowing Mushroom, Covered Mushroom and Tree Mushroom.
Removed the Glowing Mushroom from Birchwood Path.
You notice something peculiar on the ground as you step into the fog.
Spawned Glowing Mushroom in Birchwood Path.

Birchwood Path
A strange fog envelops everything, you can barely see your feet when you look down.

You see a faint glowing near the ground in the fog.

>east
MushCount before entering Birchwood: 0. Available: Glowing Mushroom, Tree Mushroom and Covered Mushroom.
Removed the Glowing Mushroom from Birchwood Path.
The path is shrouded in mist, revealing nothing out of the ordinary.
Mushroom spawn chance failed.
Mushroom spawn chance (7 in 10) failed.

Birchwood Path
A strange fog envelops everything, you can barely see your feet when you look down.

>east
MushCount before entering Birchwood: 0. Available: Glowing Mushroom, Tree Mushroom and Covered Mushroom.
You notice something peculiar on the ground as you step into the fog.
Spawned Covered Mushroom in Birchwood Path.

Birchwood Path
A strange fog envelops everything, you can barely see your feet when you look down.

A deer picks at the ground. It looks like it's trying to eat something.

>east
MushCount before entering Birchwood: 0. Available: Covered Mushroom, Tree Mushroom and Glowing Mushroom.
Removed the Covered Mushroom from Birchwood Path.
The path is shrouded in mist, revealing nothing out of the ordinary.
Mushroom spawn chance failed.
Mushroom spawn chance (8 in 10) failed.

Birchwood Path
A strange fog envelops everything, you can barely see your feet when you look down.

>east
MushCount before entering Birchwood: 0. Available: Covered Mushroom, Tree Mushroom and Glowing Mushroom.
You notice something peculiar on the ground as you step into the fog.
Spawned Glowing Mushroom in Birchwood Path.

Birchwood Path
A strange fog envelops everything, you can barely see your feet when you look down.

You see a faint glowing near the ground in the fog.

>east
MushCount before entering Birchwood: 0. Available: Glowing Mushroom, Tree Mushroom and Covered Mushroom.
Removed the Glowing Mushroom from Birchwood Path.
The path is shrouded in mist, revealing nothing out of the ordinary.
Mushroom spawn chance failed.
Mushroom spawn chance (9 in 10) failed.

Birchwood Path
A strange fog envelops everything, you can barely see your feet when you look down.

>east
MushCount before entering Birchwood: 0. Available: Glowing Mushroom, Tree Mushroom and Covered Mushroom.
You notice something peculiar on the ground as you step into the fog.
Spawned Tree Mushroom in Birchwood Path.

Birchwood Path
A strange fog envelops everything, you can barely see your feet when you look down.

You see light eminating from a hollow tree trunk.

>east
MushCount before entering Birchwood: 0. Available: Tree Mushroom, Glowing Mushroom and Covered Mushroom.
Removed the Tree Mushroom from Birchwood Path.
You notice something peculiar on the ground as you step into the fog.
Spawned Glowing Mushroom in Birchwood Path.

Birchwood Path
A strange fog envelops everything, you can barely see your feet when you look down.

You see a faint glowing near the ground in the fog.

>east
MushCount before entering Birchwood: 0. Available: Glowing Mushroom, Covered Mushroom and Tree Mushroom.
Removed the Glowing Mushroom from Birchwood Path.
You notice something peculiar on the ground as you step into the fog.
Spawned Tree Mushroom in Birchwood Path.

Birchwood Path
A strange fog envelops everything, you can barely see your feet when you look down.

You see light eminating from a hollow tree trunk.

>east
MushCount before entering Birchwood: 0. Available: Tree Mushroom, Glowing Mushroom and Covered Mushroom.
Removed the Tree Mushroom from Birchwood Path.
You notice something peculiar on the ground as you step into the fog.
Spawned Tree Mushroom in Birchwood Path.

Birchwood Path
A strange fog envelops everything, you can barely see your feet when you look down.

You see light eminating from a hollow tree trunk.

>east
MushCount before entering Birchwood: 0. Available: Tree Mushroom, Glowing Mushroom and Covered Mushroom.
Removed the Tree Mushroom from Birchwood Path.
You notice something peculiar on the ground as you step into the fog.
Spawned Covered Mushroom in Birchwood Path.

Birchwood Path
A strange fog envelops everything, you can barely see your feet when you look down.

A deer picks at the ground. It looks like it's trying to eat something.

>east
MushCount before entering Birchwood: 0. Available: Covered Mushroom, Glowing Mushroom and Tree Mushroom.
Removed the Covered Mushroom from Birchwood Path.
You notice something peculiar on the ground as you step into the fog.
Spawned Covered Mushroom in Birchwood Path.

Birchwood Path
A strange fog envelops everything, you can barely see your feet when you look down.

A deer picks at the ground. It looks like it's trying to eat something.

>east
MushCount before entering Birchwood: 0. Available: Covered Mushroom, Glowing Mushroom and Tree Mushroom.
Removed the Covered Mushroom from Birchwood Path.
You notice something peculiar on the ground as you step into the fog.
Spawned Covered Mushroom in Birchwood Path.

Birchwood Path
A strange fog envelops everything, you can barely see your feet when you look down.

A deer picks at the ground. It looks like it's trying to eat something.

>east
MushCount before entering Birchwood: 0. Available: Covered Mushroom, Glowing Mushroom and Tree Mushroom.
Removed the Covered Mushroom from Birchwood Path.
You notice something peculiar on the ground as you step into the fog.
Spawned Glowing Mushroom in Birchwood Path.

Birchwood Path
A strange fog envelops everything, you can barely see your feet when you look down.

You see a faint glowing near the ground in the fog.

>east
MushCount before entering Birchwood: 0. Available: Glowing Mushroom, Covered Mushroom and Tree Mushroom.
Removed the Glowing Mushroom from Birchwood Path.
You notice something peculiar on the ground as you step into the fog.
Spawned Covered Mushroom in Birchwood Path.

Birchwood Path
A strange fog envelops everything, you can barely see your feet when you look down.

A deer picks at the ground. It looks like it's trying to eat something.

>east
MushCount before entering Birchwood: 0. Available: Covered Mushroom, Glowing Mushroom and Tree Mushroom.
Removed the Covered Mushroom from Birchwood Path.
You notice something peculiar on the ground as you step into the fog.
Spawned Tree Mushroom in Birchwood Path.

Birchwood Path
A strange fog envelops everything, you can barely see your feet when you look down.

You see light eminating from a hollow tree trunk.

>east
MushCount before entering Birchwood: 0. Available: Tree Mushroom, Glowing Mushroom and Covered Mushroom.
Removed the Tree Mushroom from Birchwood Path.
You notice something peculiar on the ground as you step into the fog.
Spawned Covered Mushroom in Birchwood Path.

Birchwood Path
A strange fog envelops everything, you can barely see your feet when you look down.

A deer picks at the ground. It looks like it's trying to eat something.

>east
MushCount before entering Birchwood: 0. Available: Covered Mushroom, Tree Mushroom and Glowing Mushroom.
Removed the Covered Mushroom from Birchwood Path.
You notice something peculiar on the ground as you step into the fog.
Spawned Covered Mushroom in Birchwood Path.

Birchwood Path
A strange fog envelops everything, you can barely see your feet when you look down.

A deer picks at the ground. It looks like it's trying to eat something.

>east
MushCount before entering Birchwood: 0. Available: Covered Mushroom, Tree Mushroom and Glowing Mushroom.
Removed the Covered Mushroom from Birchwood Path.
You notice something peculiar on the ground as you step into the fog.
Spawned Glowing Mushroom in Birchwood Path.

Birchwood Path
A strange fog envelops everything, you can barely see your feet when you look down.

You see a faint glowing near the ground in the fog.

>east
MushCount before entering Birchwood: 0. Available: Glowing Mushroom, Covered Mushroom and Tree Mushroom.
Removed the Glowing Mushroom from Birchwood Path.
You notice something peculiar on the ground as you step into the fog.
Spawned Covered Mushroom in Birchwood Path.

Birchwood Path
A strange fog envelops everything, you can barely see your feet when you look down.

A deer picks at the ground. It looks like it's trying to eat something.

>east
MushCount before entering Birchwood: 0. Available: Covered Mushroom, Tree Mushroom and Glowing Mushroom.
Removed the Covered Mushroom from Birchwood Path.
You notice something peculiar on the ground as you step into the fog.
Spawned Glowing Mushroom in Birchwood Path.

Birchwood Path
A strange fog envelops everything, you can barely see your feet when you look down.

You see a faint glowing near the ground in the fog.

>east
MushCount before entering Birchwood: 0. Available: Glowing Mushroom, Covered Mushroom and Tree Mushroom.
Removed the Glowing Mushroom from Birchwood Path.
You notice something peculiar on the ground as you step into the fog.
Spawned Glowing Mushroom in Birchwood Path.

Birchwood Path
A strange fog envelops everything, you can barely see your feet when you look down.

You see a faint glowing near the ground in the fog.

>east
MushCount before entering Birchwood: 0. Available: Glowing Mushroom, Covered Mushroom and Tree Mushroom.
Removed the Glowing Mushroom from Birchwood Path.
You notice something peculiar on the ground as you step into the fog.
Spawned Tree Mushroom in Birchwood Path.

Birchwood Path
A strange fog envelops everything, you can barely see your feet when you look down.

You see light eminating from a hollow tree trunk.

* * *

>east
MushCount before entering Birchwood: 0. Available: Tree Mushroom, Glowing Mushroom and Covered Mushroom.
Removed the Tree Mushroom from Birchwood Path.
You notice something peculiar on the ground as you step into the fog.
Spawned Covered Mushroom in Birchwood Path.

Birchwood Path
A strange fog envelops everything, you can barely see your feet when you look down.

A deer picks at the ground. It looks like it's trying to eat something.

>east
MushCount before entering Birchwood: 0. Available: Covered Mushroom, Tree Mushroom and Glowing Mushroom.
Removed the Covered Mushroom from Birchwood Path.
You notice something peculiar on the ground as you step into the fog.
Spawned Tree Mushroom in Birchwood Path.

Birchwood Path
A strange fog envelops everything, you can barely see your feet when you look down.

You see light eminating from a hollow tree trunk.

>east
MushCount before entering Birchwood: 0. Available: Tree Mushroom, Covered Mushroom and Glowing Mushroom.
Removed the Tree Mushroom from Birchwood Path.
You notice something peculiar on the ground as you step into the fog.
Spawned Tree Mushroom in Birchwood Path.

Birchwood Path
A strange fog envelops everything, you can barely see your feet when you look down.

You see light eminating from a hollow tree trunk.

>east
MushCount before entering Birchwood: 0. Available: Tree Mushroom, Glowing Mushroom and Covered Mushroom.
Removed the Tree Mushroom from Birchwood Path.
You notice something peculiar on the ground as you step into the fog.
Spawned Glowing Mushroom in Birchwood Path.

Birchwood Path
A strange fog envelops everything, you can barely see your feet when you look down.

You see a faint glowing near the ground in the fog.

I beg your pardon?

>east
MushCount before entering Birchwood: 0. Available: Glowing Mushroom, Covered Mushroom and Tree Mushroom.
Removed the Glowing Mushroom from Birchwood Path.
You notice something peculiar on the ground as you step into the fog.
Spawned Glowing Mushroom in Birchwood Path.

Birchwood Path
A strange fog envelops everything, you can barely see your feet when you look down.

You see a faint glowing near the ground in the fog.

* * *

>east
MushCount before entering Birchwood: 0. Available: Glowing Mushroom, Covered Mushroom and Tree Mushroom.
Removed the Glowing Mushroom from Birchwood Path.
You notice something peculiar on the ground as you step into the fog.
Spawned Tree Mushroom in Birchwood Path.

Birchwood Path
A strange fog envelops everything, you can barely see your feet when you look down.

You see light eminating from a hollow tree trunk.

>east
MushCount before entering Birchwood: 0. Available: Tree Mushroom, Covered Mushroom and Glowing Mushroom.
Removed the Tree Mushroom from Birchwood Path.
You notice something peculiar on the ground as you step into the fog.
Spawned Glowing Mushroom in Birchwood Path.

Birchwood Path
A strange fog envelops everything, you can barely see your feet when you look down.

You see a faint glowing near the ground in the fog.

>east
MushCount before entering Birchwood: 0. Available: Glowing Mushroom, Tree Mushroom and Covered Mushroom.
Removed the Glowing Mushroom from Birchwood Path.
You notice something peculiar on the ground as you step into the fog.
Spawned Tree Mushroom in Birchwood Path.

Birchwood Path
A strange fog envelops everything, you can barely see your feet when you look down.

You see light eminating from a hollow tree trunk.

>east
MushCount before entering Birchwood: 0. Available: Tree Mushroom, Glowing Mushroom and Covered Mushroom.
Removed the Tree Mushroom from Birchwood Path.
You notice something peculiar on the ground as you step into the fog.
Spawned Glowing Mushroom in Birchwood Path.

Birchwood Path
A strange fog envelops everything, you can barely see your feet when you look down.

You see a faint glowing near the ground in the fog.

* * *

I beg your pardon?

>east
MushCount before entering Birchwood: 0. Available: Glowing Mushroom, Tree Mushroom and Covered Mushroom.
Removed the Glowing Mushroom from Birchwood Path.
You notice something peculiar on the ground as you step into the fog.
Spawned Covered Mushroom in Birchwood Path.

Birchwood Path
A strange fog envelops everything, you can barely see your feet when you look down.

A deer picks at the ground. It looks like it's trying to eat something.

>east
MushCount before entering Birchwood: 0. Available: Covered Mushroom, Glowing Mushroom and Tree Mushroom.
Removed the Covered Mushroom from Birchwood Path.
You notice something peculiar on the ground as you step into the fog.
Spawned Covered Mushroom in Birchwood Path.

Birchwood Path
A strange fog envelops everything, you can barely see your feet when you look down.

A deer picks at the ground. It looks like it's trying to eat something.

>east
MushCount before entering Birchwood: 0. Available: Covered Mushroom, Tree Mushroom and Glowing Mushroom.
Removed the Covered Mushroom from Birchwood Path.
You notice something peculiar on the ground as you step into the fog.
Spawned Glowing Mushroom in Birchwood Path.

Birchwood Path
A strange fog envelops everything, you can barely see your feet when you look down.

You see a faint glowing near the ground in the fog.

>east
MushCount before entering Birchwood: 0. Available: Glowing Mushroom, Tree Mushroom and Covered Mushroom.
Removed the Glowing Mushroom from Birchwood Path.
You notice something peculiar on the ground as you step into the fog.
Spawned Covered Mushroom in Birchwood Path.

Birchwood Path
A strange fog envelops everything, you can barely see your feet when you look down.

A deer picks at the ground. It looks like it's trying to eat something.

>east
MushCount before entering Birchwood: 0. Available: Covered Mushroom, Tree Mushroom and Glowing Mushroom.
Removed the Covered Mushroom from Birchwood Path.
You notice something peculiar on the ground as you step into the fog.
Spawned Glowing Mushroom in Birchwood Path.

Birchwood Path
A strange fog envelops everything, you can barely see your feet when you look down.

You see a faint glowing near the ground in the fog.

>east
MushCount before entering Birchwood: 0. Available: Glowing Mushroom, Covered Mushroom and Tree Mushroom.
Removed the Glowing Mushroom from Birchwood Path.
You notice something peculiar on the ground as you step into the fog.
Spawned Tree Mushroom in Birchwood Path.

Birchwood Path
A strange fog envelops everything, you can barely see your feet when you look down.

You see light eminating from a hollow tree trunk.

I beg your pardon?

* * *

>east
MushCount before entering Birchwood: 0. Available: Covered Mushroom, Glowing Mushroom and Tree Mushroom.
You notice something peculiar on the ground as you step into the fog.
Spawned Tree Mushroom in Birchwood Path.

Birchwood Path
A strange fog envelops everything, you can barely see your feet when you look down.

You see light eminating from a hollow tree trunk.

>ast\
That's not a verb I recognise.

>east
MushCount before entering Birchwood: 0. Available: Tree Mushroom, Glowing Mushroom and Covered Mushroom.
Removed the Tree Mushroom from Birchwood Path.
You notice something peculiar on the ground as you step into the fog.
Spawned Glowing Mushroom in Birchwood Path.

Birchwood Path
A strange fog envelops everything, you can barely see your feet when you look down.

You see a faint glowing near the ground in the fog.

>east
MushCount before entering Birchwood: 0. Available: Glowing Mushroom, Tree Mushroom and Covered Mushroom.
Removed the Glowing Mushroom from Birchwood Path.
The path is shrouded in mist, revealing nothing out of the ordinary.
Mushroom spawn chance failed.
Mushroom spawn chance (2 in 10) failed.

Birchwood Path
A strange fog envelops everything, you can barely see your feet when you look down.

>east
MushCount before entering Birchwood: 0. Available: Glowing Mushroom, Tree Mushroom and Covered Mushroom.
The path is shrouded in mist, revealing nothing out of the ordinary.
Mushroom spawn chance failed.
Mushroom spawn chance (3 in 10) failed.

Birchwood Path
A strange fog envelops everything, you can barely see your feet when you look down.

* * *

>east
MushCount before entering Birchwood: 0. Available: Glowing Mushroom, Tree Mushroom and Covered Mushroom.
The path is shrouded in mist, revealing nothing out of the ordinary.
Mushroom spawn chance failed.
Mushroom spawn chance (2 in 10) failed.

Birchwood Path
A strange fog envelops everything, you can barely see your feet when you look down.

>pickup
That's not a verb I recognise.

>pick up
What do you want to pick up?

>east
You must name something more substantial.

>east
MushCount before entering Birchwood: 0. Available: Glowing Mushroom, Tree Mushroom and Covered Mushroom.
The path is shrouded in mist, revealing nothing out of the ordinary.
Mushroom spawn chance failed.
Mushroom spawn chance (3 in 10) failed.

Birchwood Path
A strange fog envelops everything, you can barely see your feet when you look down.

>pick up
What do you want to pick up?

>go east
MushCount before entering Birchwood: 0. Available: Glowing Mushroom, Tree Mushroom and Covered Mushroom.
You notice something peculiar on the ground as you step into the fog.
Spawned Glowing Mushroom in Birchwood Path.

Birchwood Path
A strange fog envelops everything, you can barely see your feet when you look down.

You see a faint glowing near the ground in the fog.

>pick up
(the Glowing Mushroom)
You carefully pick the Glowing Mushroom. Your MushCount is now 1.

>north
Cave Entrance
You encroach on a strange terrain formation with stones that seem to heavy to move on your own.

Three oddly shaped slots are carved deep into the stone. They are all currently empty, expectantly waiting.

I beg your pardon?

>insert Glowing Mushroom into mushroom slot
I only understood you as far as wanting to insert the Glowing Mushroom into the Glowing Mushroom.

>insert Glowing Mushroom into mushslot
You can't see any such thing.

>insert Glowing Mushroom into mushslots
You carefully place the Glowing Mushroom into one of the slots. It settles in with a soft click and emits a steady, faint light.
With the Glowing Mushroom placed, one slot is now filled. Two more to go.

>insert Glowing Mushroom into mushslots
You can't see any such thing.

>go south
MushCount before entering Birchwood: 1. Available: Covered Mushroom and Tree Mushroom.
The path is shrouded in mist, revealing nothing out of the ordinary.
Mushroom spawn chance failed.
Mushroom spawn chance (2 in 10) failed.

Birchwood Path
A strange fog envelops everything, you can barely see your feet when you look down.

>go north
Cave Entrance
You encroach on a strange terrain formation with stones that seem to heavy to move on your own.

Three oddly shaped slots are carved deep into the stone. One slot now holds a mushroom, which emits a faint, almost imperceptible hum. Two empty slots remain.

>insert Tree Mushroom into mushslots
You can't see any such thing.

>go south
MushCount before entering Birchwood: 1. Available: Covered Mushroom and Tree Mushroom.
The path is shrouded in mist, revealing nothing out of the ordinary.
Mushroom spawn chance failed.
Mushroom spawn chance (3 in 10) failed.

Birchwood Path
A strange fog envelops everything, you can barely see your feet when you look down.

>go north
Cave Entrance
You encroach on a strange terrain formation with stones that seem to heavy to move on your own.

Three oddly shaped slots are carved deep into the stone. One slot now holds a mushroom, which emits a faint, almost imperceptible hum. Two empty slots remain.

>insert Covered Mushroom into mushslots
You can't see any such thing.

>go north
A solid rock wall, marked with those three oddly shaped slots, blocks further passage north. The slots seem to be waiting for something to be placed within them.

* * *

>east
Trail Entrance
You see a warning sign.

>east
MushCount before entering Birchwood: 0. Available: Glowing Mushroom, Tree Mushroom and Covered Mushroom.
You notice something peculiar on the ground as you step into the fog.
Spawned Covered Mushroom in Birchwood Path.

Birchwood Path
A strange fog envelops everything, you can barely see your feet when you look down.

A deer picks at the ground. It looks like it's trying to eat something.

>north
Cave Entrance
You encroach on a strange terrain formation with stones that seem to heavy to move on your own.

Three oddly shaped slots are carved deep into the stone. They are all currently empty, expectantly waiting.

>east
You can't go that way.

* * *

>east
Crossroads
Blahblah.

>easdt
That's not a verb I recognise.

>east
Trail Entrance
You see a warning sign.

* * *

>east
Crossroads
Blahblah.

>south
Whispering Marsh
The thick fog covers the swamp like a veil. The vegetation whispers in the wind, and ahead, the entrance to a forgotten village can be glimpsed.

>south
Burnt Village Grounds
The heart of Ashen Hollow, now in ruins. The ground is covered in ashes, and the silence is as heavy as stone.

>east
Burnt Shepherd's House
A small stone house, once modest but cozy. Ashes cover the threshold, like a shroud from the past.

>west
Burnt Village Grounds
The heart of Ashen Hollow, now in ruins. The ground is covered in ashes, and the silence is as heavy as stone.

* * *

>east
Crossroads
Blahblah.

>west
Village Center
The heart of Brelmere pulses with unease. Villagers murmur and exchange worried glances.

An old man in a soaked hood, carrying a satchel of maps and scrolls.

>west
Village Path
A leaf-covered path leads back to the village of Brelmere, silent and shrouded in mist.

>wes
That's not a verb I recognise.

>west
Forest
A dense and silent forest, covered in damp mist. Shadows dance among the ancient trunks.

>west
Glen
The fog drifts between the trees of the glade. The distant sound of running water mingles with the chirping of unseen birds. In the center of the clearing, half-buried in moss and earth, rises a stone obelisk.

A stone structure covered in moss. Glowing runes are engraved on its surface.

>west
You can't go that way.

* * *

I beg your pardon?

* * *

>go east
You feel a strong reluctance to head towards the crossroads just yet. There's a palpable sense that your true journey hasn't quite begun, that some vital insight or purpose is still missing - perhaps something to be found within the village or its immediate, quieter surroundings.

>east
Trail Entrance
You see a warning sign.

>east
Birchwood Path
A strange fog envelops everything, you can barely see your feet when you look down.

You see light eminating from a hollow tree trunk.

* * *

>go east
You feel a strong reluctance to head towards the crossroads just yet. There's a palpable sense that your true journey hasn't quite begun, that some vital insight or purpose is still missing - perhaps something to be found within the village or its immediate, quieter surroundings.

>go east
Trail Entrance
You see a warning sign.

>go east
Birchwood Path
A strange fog envelops everything, you can barely see your feet when you look down.

>go east
Birchwood Path
A strange fog envelops everything, you can barely see your feet when you look down.

>look around
You can't see any such thing.

* * *

>go east
You feel a strong reluctance to head towards the crossroads just yet. There's a palpable sense that your true journey hasn't quite begun, that some vital insight or purpose is still missing - perhaps something to be found within the village or its immediate, quieter surroundings.

>go west
Village Path
A leaf-covered path leads back to the village of Brelmere, silent and shrouded in mist.

* * *

>go west
Glen
The fog drifts between the trees of the glade. The distant sound of running water mingles with the chirping of unseen birds. In the center of the clearing, half-buried in moss and earth, rises a stone obelisk.

A stone structure covered in moss. Glowing runes are engraved on its surface.

>go west
A peculiar sense of unease holds you back from venturing further west for now, as if the ancient trees themselves are barring your way. Perhaps there's something of significance here in this glade that you must understand before the path into the deeper wilds will reveal itself.

* * *

>go east
Crossroads
Blahblah.

>go east
Trail Entrance
You see a warning sign.

>go east
Birchwood Path
A strange fog envelops everything, you can barely see your feet when you look down.

You can see a Covered Mushroom here.

>go east
Birchwood Path
A strange fog envelops everything, you can barely see your feet when you look down.

You can see a Covered Mushroom here.

>go north
Birchwood Path
A strange fog envelops everything, you can barely see your feet when you look down.

You see a faint glowing near the ground in the fog.

* * *

>pickup
That's not a verb I recognise.

>east
Crossroads
Blahblah.

* * *

>east
MushCount before entering Birchwood: 0. Available: Glowing Mushroom, Tree Mushroom and Covered Mushroom.
The path is shrouded in mist, revealing nothing out of the ordinary.
Mushroom spawn chance failed.

Birchwood Path
A strange fog envelops everything, you can barely see your feet when you look down.

>east
MushCount before entering Birchwood: 0. Available: Glowing Mushroom, Tree Mushroom and Covered Mushroom.
You notice something peculiar on the ground as you step into the fog.
Spawned Covered Mushroom in Birchwood Path.

Birchwood Path
A strange fog envelops everything, you can barely see your feet when you look down.

A deer picks at the ground. It looks like it's trying to eat something.

>pickup
That's not a verb I recognise.

>pickup mushroom
That's not a verb I recognise.

>pick up
(the Covered Mushroom)
You carefully pick the Covered Mushroom. Your MushCount is now 1.

>east
MushCount before entering Birchwood: 1. Available: Glowing Mushroom and Tree Mushroom.
The path is shrouded in mist, revealing nothing out of the ordinary.
Mushroom spawn chance failed.

Birchwood Path
A strange fog envelops everything, you can barely see your feet when you look down.

>east
MushCount before entering Birchwood: 1. Available: Glowing Mushroom and Tree Mushroom.
You notice something peculiar on the ground as you step into the fog.
Spawned Glowing Mushroom in Birchwood Path.

Birchwood Path
A strange fog envelops everything, you can barely see your feet when you look down.

You see a faint glowing near the ground in the fog.

* * *

>esat
That's not a verb I recognise.

>east
Crossroads
Blahblah.

* * *

>west
MushCount before entering Birchwood: 0. Available: Glowing Mushroom, Tree Mushroom and Covered Mushroom.
The path is shrouded in mist, revealing nothing out of the ordinary.
Mushroom spawn chance failed.
Mushroom spawn chance (3 in 10) failed.

Birchwood Path
A strange fog envelops everything, you can barely see your feet when you look down.

>east
MushCount before entering Birchwood: 0. Available: Glowing Mushroom, Tree Mushroom and Covered Mushroom.
The path is shrouded in mist, revealing nothing out of the ordinary.
Mushroom spawn chance failed.
Mushroom spawn chance (4 in 10) failed.

Birchwood Path
A strange fog envelops everything, you can barely see your feet when you look down.

>eaas
That's not a verb I recognise.

>east
MushCount before entering Birchwood: 0. Available: Glowing Mushroom, Tree Mushroom and Covered Mushroom.
The path is shrouded in mist, revealing nothing out of the ordinary.
Mushroom spawn chance failed.
Mushroom spawn chance (5 in 10) failed.

Birchwood Path
A strange fog envelops everything, you can barely see your feet when you look down.

>east
MushCount before entering Birchwood: 0. Available: Glowing Mushroom, Tree Mushroom and Covered Mushroom.
The path is shrouded in mist, revealing nothing out of the ordinary.
Mushroom spawn chance failed.
Mushroom spawn chance (6 in 10) failed.

Birchwood Path
A strange fog envelops everything, you can barely see your feet when you look down.

>east
MushCount before entering Birchwood: 0. Available: Glowing Mushroom, Tree Mushroom and Covered Mushroom.
You notice something peculiar on the ground as you step into the fog.
Spawned Covered Mushroom in Birchwood Path.

Birchwood Path
A strange fog envelops everything, you can barely see your feet when you look down.

A deer picks at the ground. It looks like it's trying to eat something.

* * *

>pick up
(the Covered Mushroom)
You carefully pick the Covered Mushroom. Your MushCount is now 1.

>ast
That's not a verb I recognise.

>east
MushCount before entering Birchwood: 1. Available: Glowing Mushroom and Tree Mushroom.
The path is shrouded in mist, revealing nothing out of the ordinary.
Mushroom spawn chance failed.
Mushroom spawn chance (2 in 10) failed.

Birchwood Path
A strange fog envelops everything, you can barely see your feet when you look down.

>east
MushCount before entering Birchwood: 1. Available: Glowing Mushroom and Tree Mushroom.
You notice something peculiar on the ground as you step into the fog.
Spawned Glowing Mushroom in Birchwood Path.

Birchwood Path
A strange fog envelops everything, you can barely see your feet when you look down.

You see a faint glowing near the ground in the fog.

* * *

>pick up
(the Glowing Mushroom)
You carefully pick the Glowing Mushroom. Your MushCount is now 2.

>east
MushCount before entering Birchwood: 2. Available: Tree Mushroom.
You notice something peculiar on the ground as you step into the fog.
Spawned Tree Mushroom in Birchwood Path.

Birchwood Path
A strange fog envelops everything, you can barely see your feet when you look down.

You see light eminating from a hollow tree trunk.

* * *

>pick up
(the Tree Mushroom)
You carefully pick the Tree Mushroom. Your MushCount is now 3.

>north
Cave Entrance
You encroach on a strange terrain formation with stones that seem to heavy to move on your own.

Three oddly shaped slots are carved deep into the stone. They are all currently empty, expectantly waiting.

>insert Mushroom into slot
Which do you mean, the Tree Mushroom, the Glowing Mushroom or the Covered Mushroom?

>insert Tree Mushroom into slot
The Tree Mushroom slides into a slot with a snug fit. You hear a faint, woody resonance.
With the Tree Mushroom placed, one slot is now filled. Two more to go.

>insert Tree Mushroom into slots
You can't see any such thing.

>insert Glowing Mushroom into slots
You carefully place the Glowing Mushroom into one of the slots. It settles in with a soft click and emits a steady, faint light.
That's two mushrooms in place now. Just one more mystical fungus needed!

>insert Covered Mushroom into slots
The Covered Mushroom fits neatly into a slot. A subtle earthy scent wafts from it.
As the Covered Mushroom settles into the final slot, all three mushrooms begin to glow in powerful unison, their combined light pushing back the shadows. A deep, resonant hum vibrates through the very stone beneath your feet. With a slow, grinding groan that echoes around the clearing, the rock wall shudders and then slides ponderously aside, revealing a dark passage leading north into the mountain's heart!

>go northg
You can't see any such thing.

>go into Crystal Caverns
You can't see any such thing.

>go north
Crystal Caverns
BALGLAGLASDLGDSLG.

You can see a Dragon Eye here.

* * *

>go north
You can't go that way.

>go east
You can't go that way.

>go south
Cave Entrance
You encroach on a strange terrain formation with stones that seem to heavy to move on your own.

Three oddly shaped slots are carved deep into the stone. All three slots are now filled with mushrooms. They seem to pulse with a gentle, collective energy, as if waiting for a final catalyst or perhaps having already fulfilled their purpose.

>go north
Crystal Caverns
BALGLAGLASDLGDSLG.

>go west
You can't go that way.

>go south
Cave Entrance
You encroach on a strange terrain formation with stones that seem to heavy to move on your own.

Three oddly shaped slots are carved deep into the stone. All three slots are now filled with mushrooms. They seem to pulse with a gentle, collective energy, as if waiting for a final catalyst or perhaps having already fulfilled their purpose.

>go south
MushCount before entering Birchwood: 3. Available: .
The path is shrouded in mist, revealing nothing out of the ordinary.
Mushroom spawn chance failed.
Mushroom spawn chance (2 in 10) failed.

Birchwood Path
A strange fog envelops everything, you can barely see your feet when you look down.

>go east
MushCount before entering Birchwood: 3. Available: .
The fog seems particularly uneventful this time.
 Tried to spawn, but no available mushrooms left.

Birchwood Path
A strange fog envelops everything, you can barely see your feet when you look down.

>go west
Trail Entrance
You see a warning sign.

>go east
MushCount before entering Birchwood: 3. Available: .
The path is shrouded in mist, revealing nothing out of the ordinary.
Mushroom spawn chance failed.
Mushroom spawn chance (4 in 10) failed.

Birchwood Path
A strange fog envelops everything, you can barely see your feet when you look down.

>go west
Trail Entrance
You see a warning sign.

>go east
MushCount before entering Birchwood: 3. Available: .
The path is shrouded in mist, revealing nothing out of the ordinary.
Mushroom spawn chance failed.
Mushroom spawn chance (5 in 10) failed.

Birchwood Path
A strange fog envelops everything, you can barely see your feet when you look down.

>go east
MushCount before entering Birchwood: 3. Available: .
The fog seems particularly uneventful this time.
 Tried to spawn, but no available mushrooms left.

Birchwood Path
A strange fog envelops everything, you can barely see your feet when you look down.

>go east
MushCount before entering Birchwood: 3. Available: .
The fog seems particularly uneventful this time.
 Tried to spawn, but no available mushrooms left.

Birchwood Path
A strange fog envelops everything, you can barely see your feet when you look down.

>goeast
That's not a verb I recognise.

>go west
Trail Entrance
You see a warning sign.

* * *

>west
Village Path
A leaf-covered path leads back to the village of Brelmere, silent and shrouded in mist.

>west
Forest
A dense and silent forest, covered in damp mist. Shadows dance among the ancient trunks.

* * *

>west
Glen
The fog drifts between the trees of the glade. The distant sound of running water mingles with the chirping of unseen birds. In the center of the clearing, half-buried in moss and earth, rises a stone obelisk.

A stone structure covered in moss. Glowing runes are engraved on its surface.

>west
Valley

>west
Cliff

>west
Skyreach Monastery Exterior
You've reached the monastery atop the sheer cliffs of Skyreach. It is eerily silent and clearly abandoned. Ancient scrolls, tattered by wind and time, lay scattered across a weathered courtyard. The monastery's great bell has toppled from its tower, half-buried and cracked.

>north
Skyreach Interior Hall
This vast, circular hall must have been the heart of the Skyreach Monastery. Dust motes dance in the few rays of light that pierce the gloom from high, narrow windows. The air is still and heavy with forgotten prayers. In the very center of the stone floor, a large, intricate circular pattern is deeply carved.

You can see a FloorSockets here.

>village
That's not a verb I recognise.

>village center
That's not a verb I recognise.

>south
Skyreach Monastery Exterior
You've reached the monastery atop the sheer cliffs of Skyreach. It is eerily silent and clearly abandoned. Ancient scrolls, tattered by wind and time, lay scattered across a weathered courtyard. The monastery's great bell has toppled from its tower, half-buried and cracked.

>east
Cliff

>east
Valley

>ast
That's not a verb I recognise.

>east
Glen
The fog drifts between the trees of the glade. The distant sound of running water mingles with the chirping of unseen birds. In the center of the clearing, half-buried in moss and earth, rises a stone obelisk.

A stone structure covered in moss. Glowing runes are engraved on its surface.

>east
Forest
A dense and silent forest, covered in damp mist. Shadows dance among the ancient trunks.

>easdt
That's not a verb I recognise.

>east
Village Path
A leaf-covered path leads back to the village of Brelmere, silent and shrouded in mist.

>east
Village Center
The heart of Brelmere pulses with unease. Villagers murmur and exchange worried glances.

An old man in a soaked hood, carrying a satchel of maps and scrolls.

>east
Crossroads
Blahblah.

* * *

>east
MushCount before entering Birchwood: 0. Available: Glowing Mushroom, Tree Mushroom and Covered Mushroom.
The path is shrouded in mist, revealing nothing out of the ordinary.
Mushroom spawn chance failed.
Mushroom spawn chance (2 in 10) failed.

Birchwood Path
A strange fog envelops everything, you can barely see your feet when you look down.

>east
MushCount before entering Birchwood: 0. Available: Glowing Mushroom, Tree Mushroom and Covered Mushroom.
You notice something peculiar on the ground as you step into the fog.
Spawned Glowing Mushroom in Birchwood Path.

Birchwood Path
A strange fog envelops everything, you can barely see your feet when you look down.

You see a faint glowing near the ground in the fog.

>pick up
(the Glowing Mushroom)
You carefully pick the Glowing Mushroom. Your MushCount is now 1.

>east
MushCount before entering Birchwood: 1. Available: Tree Mushroom and Covered Mushroom.
The path is shrouded in mist, revealing nothing out of the ordinary.
Mushroom spawn chance failed.
Mushroom spawn chance (2 in 10) failed.

Birchwood Path
A strange fog envelops everything, you can barely see your feet when you look down.

>pick up
(the Glowing Mushroom)
You already have that.

>east
MushCount before entering Birchwood: 1. Available: Tree Mushroom and Covered Mushroom.
The path is shrouded in mist, revealing nothing out of the ordinary.
Mushroom spawn chance failed.
Mushroom spawn chance (3 in 10) failed.

Birchwood Path
A strange fog envelops everything, you can barely see your feet when you look down.

>pick up
(the Glowing Mushroom)
You already have that.

>east
MushCount before entering Birchwood: 1. Available: Tree Mushroom and Covered Mushroom.
You notice something peculiar on the ground as you step into the fog.
Spawned Tree Mushroom in Birchwood Path.

Birchwood Path
A strange fog envelops everything, you can barely see your feet when you look down.

You see light eminating from a hollow tree trunk.

>pick up
(the Tree Mushroom)
You carefully pick the Tree Mushroom. Your MushCount is now 2.

>east
MushCount before entering Birchwood: 2. Available: Covered Mushroom.
The path is shrouded in mist, revealing nothing out of the ordinary.
Mushroom spawn chance failed.
Mushroom spawn chance (2 in 10) failed.

Birchwood Path
A strange fog envelops everything, you can barely see your feet when you look down.

>east
MushCount before entering Birchwood: 2. Available: Covered Mushroom.
You notice something peculiar on the ground as you step into the fog.
Spawned Covered Mushroom in Birchwood Path.

Birchwood Path
A strange fog envelops everything, you can barely see your feet when you look down.

A deer picks at the ground. It looks like it's trying to eat something.

>pick up
(the Covered Mushroom)
You carefully pick the Covered Mushroom. Your MushCount is now 3.

>go north
Cave Entrance
You encroach on a strange terrain formation with stones that seem to heavy to move on your own.

Three oddly shaped slots are carved deep into the stone. They are all currently empty, expectantly waiting.

>insert Glowing into slot
You carefully place the Glowing Mushroom into one of the slots. It settles in with a soft click and emits a steady, faint light.
With the Glowing Mushroom placed, one slot is now filled. Two more to go.

>insert Tree into slot
The Tree Mushroom slides into a slot with a snug fit. You hear a faint, woody resonance.
That's two mushrooms in place now. Just one more mystical fungus needed!

>Insert Covered into slots
The Covered Mushroom fits neatly into a slot. A subtle earthy scent wafts from it.
As the Covered Mushroom settles into the final slot, all three mushrooms begin to glow in powerful unison, their combined light pushing back the shadows. A deep, resonant hum vibrates through the very stone beneath your feet. With a slow, grinding groan that echoes around the clearing, the rock wall shudders and then slides ponderously aside, revealing a dark passage leading north into the mountain's heart!

>go nort
You can't see any such thing.

>go north
Crystal Caverns
BALGLAGLASDLGDSLG.

You can see a Dragon Eye here.

* * *

>south
Cave Entrance
You encroach on a strange terrain formation with stones that seem to heavy to move on your own.

Three oddly shaped slots are carved deep into the stone. All three slots are now filled with mushrooms. They seem to pulse with a gentle, collective energy, as if waiting for a final catalyst or perhaps having already fulfilled their purpose.

>south
MushCount before entering Birchwood: 3. Available: .
The path is shrouded in mist, revealing nothing out of the ordinary.
Mushroom spawn chance failed.
Mushroom spawn chance (2 in 10) failed.

Birchwood Path
A strange fog envelops everything, you can barely see your feet when you look down.

>west
Crossroads
Blahblah.

>south
Whispering Marsh
The thick fog covers the swamp like a veil. The vegetation whispers in the wind, and ahead, the entrance to a forgotten village can be glimpsed.

* * *

>south
Burnt Village Grounds
The heart of Ashen Hollow, now in ruins. The ground is covered in ashes, and the silence is as heavy as stone.

>go northeast
Burnt Seer's House
The seer's former dwelling. Fragments of colored glass still glint in the broken windows, as if awaiting new visions.

You can see a Seer's Note here.

* * *

>go southwest
Burnt Village Grounds
The heart of Ashen Hollow, now in ruins. The ground is covered in ashes, and the silence is as heavy as stone.

>go south
Burnt Blacksmith
Twisted tools and molten metals are scattered across the floor. The ancient heat still seems to emanate from the blackened walls.

You can see a Blacksmith's Note here.

* * *

>go north
Whispering Marsh
The thick fog covers the swamp like a veil. The vegetation whispers in the wind, and ahead, the entrance to a forgotten village can be glimpsed.

>go north
Crossroads
Blahblah.

>go east
MushCount before entering Birchwood: 3. Available: .
The path is shrouded in mist, revealing nothing out of the ordinary.
Mushroom spawn chance failed.
Mushroom spawn chance (3 in 10) failed.

Birchwood Path
A strange fog envelops everything, you can barely see your feet when you look down.

* * *

>go west
Crossroads
Blahblah.

>go west
Village Center
The heart of Brelmere pulses with unease. Villagers murmur and exchange worried glances.

An old man in a soaked hood, carrying a satchel of maps and scrolls.

* * *

>go north
Skyreach Interior Hall
This vast, circular hall must have been the heart of the Skyreach Monastery. Dust motes dance in the few rays of light that pierce the gloom from high, narrow windows. The air is still and heavy with forgotten prayers. In the very center of the stone floor, a large, intricate circular pattern is deeply carved.

You can see a FloorSockets here.

>insert Eye into socket
You carefully place the Dragon Eye into the round, orb-shaped socket. It fits perfectly, and for a moment, the flame within the Eye seems to flare, casting dancing shadows.
The Eye rests in its socket, pulsing faintly. The other socket remains empty.

>insert scale into socket
You lay the Dragon Scale into the teardrop-shaped depression. It settles with a soft click, its weight seeming to press down on a hidden mechanism.

As both the Eye and Scale settle into their respective sockets, the carved lines of the floor pattern begin to glow with an intense, ethereal light! The air crackles with energy. Suddenly, a deafening CRACK shatters the silence as a brilliant bolt of pure lightning descends from the shadowy ceiling above, striking the very center of the pattern with pinpoint accuracy!
Where the lightning struck, the stone floor has been blasted open, or perhaps magically parted. Amidst smoking edges, the Stone of Storms now lies revealed. It is a shard of obsidian, humming with a potent, contained energy and reflecting an unseen light within its polished facets.
You glance upwards. Through a newly formed, jagged hole in the monastery's ancient roof, the previously tumultuous storm clouds are rapidly parting, revealing a serene, starlit sky. The howling wind that buffeted the monastery dies down to a gentle, almost reverent breeze.
In the newfound stillness, a mighty, triumphant roar echoes from some far-distant mountain peak, carried on the clear night air.

>picku
That's not a verb I recognise.

>pickup
That's not a verb I recognise.

* * *

>pick up
What do you want to pick up?

>inventory
You are carrying:
  a Tavern Note
  a Blacksmith's Note
  a Seer's Note

>pick up stone
Taken.

>inventory
You are carrying:
  a Stone Of Storms
  a Tavern Note
  a Blacksmith's Note
  a Seer's Note

* * *

>go west
Village Path
A leaf-covered path leads back to the village of Brelmere, silent and shrouded in mist.

* * *

>go west
Glen
The fog drifts between the trees of the glade. The distant sound of running water mingles with the chirping of unseen birds. In the center of the clearing, half-buried in moss and earth, rises a stone obelisk.

A stone structure covered in moss. Glowing runes are engraved on its surface.

>examine
(the Obelisk)
The runes glow softly: "In flame I slept, in storm I woke. My heart was stolen, my wings denied. Seek the eye, the scale, the stone - return them, and I shall soar again." As you touch the letters, you feel a strange pulse beneath the stone.

Tarin's heart races. The words echo like a long-forgotten prophecy.

>look at
(the Obelisk)
The runes glow softly: "In flame I slept, in storm I woke. My heart was stolen, my wings denied. Seek the eye, the scale, the stone - return them, and I shall soar again." As you touch the letters, you feel a strange pulse beneath the stone.

>exit
But you aren't in anything at the moment.

>go west
Valley
A narrow, wind-scoured valley carves its arduous way through the lower shoulders of the mountains. The path is rough and uneven, littered with fallen scree from the towering rock walls that flank you. The constant, mournful moan of the wind echoes between these stony sentinels, carrying with it the chill of higher altitudes.

>go east
Glen
The fog drifts between the trees of the glade. The distant sound of running water mingles with the chirping of unseen birds. In the center of the clearing, half-buried in moss and earth, rises a stone obelisk.

A stone structure covered in moss. Glowing runes are engraved on its surface.

>go eas
You can't see any such thing.

>remember
"In flame I slept, in storm I woke. My heart was stolen, my wings denied. Seek the eye, the scale, the stone - return them, and I shall soar again."

>go east
Forest
A dense and silent forest, covered in damp mist. Shadows dance among the ancient trunks.

* * *

>go northwest
Elder House
An old house with an arched roof, where the village elder receives those who seek wisdom. A sturdy study table sits near the hearth, covered in scrolls and old tomes. A beautiful golden pendant rests invitingly amongst the clutter on the table.

The elder sits before the fire, eyes half-closed, as if hearing ancient voices in the crackling flames.

You can also see a Guiding Stone here.

>go north
You can't go that way.

>go northeast
Village Center
The heart of Brelmere pulses with unease. Villagers murmur and exchange worried glances.

An old man in a soaked hood, carrying a satchel of maps and scrolls.

* * *

>go northwest
Elder House
An old house with an arched roof, where the village elder receives those who seek wisdom. A sturdy study table sits near the hearth, covered in scrolls and old tomes. A beautiful golden pendant rests invitingly amongst the clutter on the table.

The elder sits before the fire, eyes half-closed, as if hearing ancient voices in the crackling flames.

You can also see a Guiding Stone here.

>go southeast
Village Center
The heart of Brelmere pulses with unease. Villagers murmur and exchange worried glances.

An old man in a soaked hood, carrying a satchel of maps and scrolls.

>go west
Village Path
A leaf-covered path leads back to the village of Brelmere, silent and shrouded in mist.

* * *

>examine
(the Obelisk)
The runes glow softly: "In flame I slept, in storm I woke. My heart was stolen, my wings denied. Seek the eye, the scale, the stone - return them, and I shall soar again." As you touch the letters, you feel a strange pulse beneath the stone.

Tarin's heart races. The words echo like a long-forgotten prophecy.

>go east
Forest
A dense and silent forest, covered in damp mist. Shadows dance among the ancient trunks.

>go east
Village Path
A leaf-covered path leads back to the village of Brelmere, silent and shrouded in mist.

>go east
Village Center
The heart of Brelmere pulses with unease. Villagers murmur and exchange worried glances.

An old man in a soaked hood, carrying a satchel of maps and scrolls.

>go northwest
Elder House
An old house with an arched roof, where the village elder receives those who seek wisdom. A sturdy study table sits near the hearth, covered in scrolls and old tomes. A beautiful golden pendant rests invitingly amongst the clutter on the table.

The elder sits before the fire, eyes half-closed, as if hearing ancient voices in the crackling flames.

You can also see a Guiding Stone here.

>go southeast
As you turn towards the doorway, intending to leave, the Elder clears his throat softly. "One moment more, young Tarin."

He rises from his chair with a deliberate slowness, retrieves the gleaming golden pendant from his study table, and steps towards you.

"The path revealed by the Obelisk is an ancient and perilous one," he says, his voice imbued with a quiet solemnity. "Many have faltered where you intend to tread. This is a Guiding Stone." He gently presses the warm pendant into your hand. "It has rested here for longer than most in Brelmere can recall, waiting for a true seeker to aid. It may help you find your way when confusion reigns and the ways are shrouded in more than just mist. Keep it close, listen to its whispers."

(You now possess the Guiding Stone.)

The Elder gives you a final, encouraging nod. "Go now, and may wisdom light your steps."

Village Center
The heart of Brelmere pulses with unease. Villagers murmur and exchange worried glances.

An old man in a soaked hood, carrying a satchel of maps and scrolls.

* * *

>go northeast
You can't go that way.

>go northwest
Elder House
An old house with an arched roof, where the village elder receives those who seek wisdom. A sturdy study table sits near the hearth, covered in scrolls and old tomes. A beautiful golden pendant rests invitingly amongst the clutter on the table.

a beautiful golden pendant

The elder sits before the fire, eyes half-closed, as if hearing ancient voices in the crackling flames.

>go southwest
Shepherd's Cottage
Tarin's modest stone-and-thatch cottage feels uneasy beneath the gray sky.

Miren lies pale and struggling to breathe. The air is thick with the smell of bitter herbs.

>go northeast
Village Center
The heart of Brelmere pulses with unease. Villagers murmur and exchange worried glances.

An old man in a soaked hood, carrying a satchel of maps and scrolls.

* * *

>look at man
His face is marked by worry. He brings ill tidings.

>speak to mean
I didn't understand that sentence.

>speak to man
I didn't understand that sentence.

>speak with man
"The dragon... is gone," he says. "Emberwing vanished from the Isle of Ash. The crops fail. Beasts grow restless. And now this..." - he points to the stormy sky. He stutters "I-I-I must get to word to the Skyreach Monastery to-o-o-o the west!